x - - - - - p p - - - x
x - - - p - s s - - - x
x - - - s - - - - - - x
x - - - - - p - - - - x
x - - - - - s - - - - x
x - - - p - - - - - - x
x - - - s - - - - - - x
x - - - - - p p - - - x
x - - - - - s s - - - x
x - - - p - - - - - - x
x - - p p - p - p - - x
x - - s s - s p s - - x
x p - - s - - s - p - x
x p p - - - - - - s - x
x s s - - - - p - - - x
x s - - p p - s - p - x
x - - - s s - - - s - x
x p p - - - - - - - - x
x s s - p - - p p - - x
x - - - s - - s s - - x