x - - p - - - - - - p x
x - - s - - - - - - s x
x - - p - - - - - - p x
x - - s - - - - - - s x
x - p p p p p p p p - x
x - s s s s s s s s - x
x p - - - - - p - - - x
x s - - - - - s - - - x
x - - p p - - p - - - x
x - - s s - - s - - - x
x - - - - - - - - p p x
x - - - - - - - - s s x
x - - - - - - p - - - x
x - - - - - - s - - - x
x - - - - p - - - - - x
x p p - - s - - - - - x
x s s - - - - - - - - x
x - - - - p p - - - - x
x p - - - s s p p p p x
x s - - - - - s s s s x