x - - - p p p p - - - x
x - - - s s s s - - - x
x - - p - - - - p - - x
x - - s - - - - s - - x
x - - - - p p - - - - x
x - - - - s s - - - - x
x - p - - - - - - p - x
x p p p - - - - p p p x
x s p s - - - - s p s x
x - s - p - - p - s - x
x - - - s - - s - s - x
x - p - - - - - - p - x
x - s - - - - - - s - x
x - - - - p p - p - - x
x - - p - s s - p - - x
x - - p - - - p p - - x
x - - p p - - s s - - x
x p - p s - - - s - p x
x s - s - - - p p p s x
x - - s - - - s s s - x