x - - p - - - - - - - x
x - - p p p - - - - - x
x - - s s s - - - p p x
x - - s - - p - - s s x
x - - - - - s p - - - x
x - - - p s - s - - - x
x - - - p p - - - - - x
x - - - s s - - - - - x
x - - - s - - p p - - x
x - - - - - - s s - - x
x - - - - p p - - p p x
x - - - - s s - - s s x
x - - - - - - p p - - x
x - - - - - - s s - - x
x - - - - p - - - - - x
x - - - p p p - - - - x
x - - - s s s - - - - x
x - - - - - - - - - p x
x - - - - - - p p p s x
x - - - - - - s s s - x