x p - - - - - - - - - x
x p p - p - - p - - - x
x s s - s - - s - - - x
x s - p - p p - p - - x
x - - s - s s - s - - x
x - - - - - - p - - - x
x - - - - - - s - - - x
x - - - - - p - p - - x
x - - - - - s - s - - x
x - - - - - - p p - p x
x - - - - - - s s - s x
x - - - - p - p - p - x
x - - - - s - s - s - x
x - - p p - - - - - - x
x - - s s - - - - - - x
x - - - - - p - - - - x
x - - - - - s - - - p x
x - - - - p - - - - s x
x p - - - s - p p p - x
x s - - - - - s s s - x