x - p - - - - - - p - x
x - s - - - p p p s - x
x - - - - - s s s - - x
x - - - - - - - p p p x
x - - - - - - p s s s x
x - - - p p p s - - - x
x - - - s s s - - - - x
x p p - - - - - - - - x
x s s - - - - - - - - x
x - - - p p p - - - - x
x - - - s s p p - - - x
x - - - - - s p p p - x
x - - - - - s s s s - x
x - - - - - - s - - p x
x - - - - - - p p p s x
x - - - p p p s s s - x
x p p - s s s - - - - x
x s s p p - - - - - - x
x - - s s p p p p - - x
x - - - - s s s s - - x