- - - - - - - - - - - - - - - - - - -
- - - - - - - - - - - - - - - - - - -
- - - - - - - - - - - - - - - - - - -
- - - - - - - - - - - - - - - - - - p
- - - - - - - - - - - - - - - - - - s
- - - - - - - - - - - - - - - - - - -
- - - - - - - - - - - - - - - - p - -
- - - - - - - - - - - - - - - - s - -
- - - - - - - - - - - - - - - - - - -
- - - - - - - - - - - - - - p - - - -
- - - - - - - - - - - - - - s - - - -
- - - - - - - - - - - - p - - - - - -
- - - - - - - - - p p - s - - - - - -
- - - - - - - - - s s - - - - - - - -
- - p p p p p p - - - - - - - - - - -
- - s s s s s s - - - - - - - - - - -
- - - - - - s s - - - - - - - - - - -